430 210
404 197
n n n n
100
-7 33 52 17 0 0 0 120 150
45 33 395 17 0 0 0 120 150
-7 50 447 161 0 2 0 120 150
-6 126 14 68 1 0 130 130 130
-6 185 14 27 1 0 100 100 100
-5 201 442 15 1 0 80 100 50
242 63 13 6 0 0 255 150 0
259 73 15 6 2 0 255 150 0
225 83 18 8 2 0 255 150 0
262 41 19 9 2 0 255 150 0
209 46 19 8 2 0 255 150 0
212 47 2 2 2 0 0 0 0
264 42 2 2 2 0 0 0 0
245 64 2 1 0 0 0 0 0
261 74 2 3 2 0 0 0 0
229 84 3 3 2 0 0 0 0
276 38 5 15 2 0 255 150 0
224 42 4 17 2 0 255 150 0
252 61 3 10 0 0 255 150 0
270 71 4 11 2 0 255 150 0
239 81 4 13 2 0 255 150 0
200 196 14 8 0 0 90 90 90
230 197 10 8 0 0 90 90 90
218 203 9 6 0 0 90 90 90
172 200 11 7 0 0 90 90 90
252 195 10 7 2 0 90 90 90
356 196 9 6 2 0 90 90 90
301 196 13 6 0 0 90 90 90
332 198 10 8 0 0 90 90 90
390 195 13 8 0 0 90 90 90
275 192 17 13 1 0 90 90 90
-7 -9 449 42 0 0 0 220 255
-6 33 36 21 1 0 100 80 0
-6 50 50 71 1 0 90 80 30
-6 118 57 75 1 0 90 80 30
-7 185 83 23 1 0 80 100 50
-4 126 54 59 1 0 90 80 30
-3 144 67 41 1 0 90 100 50
-6 32 27 4 1 0 0 130 0
13 32 17 4 1 0 170 170 3
39 75 8 58 1 0 90 80 30
42 105 6 36 1 0 90 80 30
47 130 8 14 1 0 90 80 30
52 137 9 7 1 0 90 80 30
26 41 11 9 1 0 100 80 0
28 37 5 6 1 0 100 80 0
32 39 3 4 1 0 100 80 0
36 43 4 7 1 0 100 80 0
39 45 3 5 1 0 100 80 0
41 58 4 23 1 0 90 80 30
43 65 3 25 1 0 90 80 30
48 121 4 15 1 0 90 80 30
50 125 3 15 1 0 90 80 30
54 134 3 7 1 0 90 80 30
55 139 7 5 1 0 90 80 30
55 147 12 38 1 0 90 100 50
63 158 10 27 1 0 90 100 50
65 154 5 8 1 0 90 100 50
-2 143 16 7 1 0 90 100 50
10 142 15 3 1 0 90 100 50
22 143 16 6 1 0 90 100 50
32 142 12 5 1 0 90 100 50
34 141 13 5 1 0 90 100 50
38 142 12 4 1 0 90 100 50
44 143 14 8 1 0 90 100 50
18 141 18 14 1 0 90 100 50
70 189 8 12 1 0 80 100 50
74 194 5 10 1 0 80 100 50
61 182 13 6 1 0 80 100 50
44 179 16 10 1 0 80 100 50
33 180 17 8 1 0 80 100 50
18 180 22 11 1 0 80 100 50
4 178 22 13 1 0 80 100 50
-9 181 16 4 1 0 80 100 50
88 188 9 13 2 0 0 110 0
91 170 8 19 2 0 0 110 0
88 152 6 20 2 0 0 110 0
90 141 6 13 2 0 0 110 0
104 183 5 19 2 0 0 110 0
101 168 5 18 2 0 0 110 0
99 157 4 11 2 0 0 110 0
99 139 4 18 2 0 0 110 0
113 182 4 20 2 0 0 110 0
115 165 5 18 2 0 0 110 0
112 151 5 16 2 0 0 110 0
115 139 4 15 2 0 0 110 0
126 180 5 22 2 0 0 110 0
125 155 4 26 2 0 0 110 0
127 141 5 17 2 0 0 110 0
134 189 6 12 2 0 0 110 0
136 173 5 19 2 0 0 110 0
135 160 4 17 2 0 0 110 0
136 142 5 20 2 0 0 110 0
135 135 4 10 2 0 0 110 0
152 180 5 22 2 0 0 110 0
149 159 6 25 2 0 0 110 0
152 145 5 20 2 0 0 110 0
433 -3 8 219 1 0 255 0 153
-14 -10 13 54 1 0 255 0 153
-2 35 34 4 1 0 100 80 0
0

//file format:

mapWidth mapHeight
spawnPointX spawnPointY
edgeWarpLeftMap edgeWarpRightMap edgeWarpUpMap edgeWarpDownMap //n means none, player just warps to opposite side of current map
numberOfShapesToReadFromTheFile
topLeftCornerX topLeftCornerY width height collision climbability r g b //each of these lines represents one shape
warpCount
warpToMapNum warpToXCoord warpToYCoord //n means warp destination is the same as current map

//collision can be: 0 (no collision, draw behind char), 1 (collision), 2 (no collision, draw in front of char), 3 (no collision oval, draw behind char), 4 (no collision oval, draw in front of char), or 5 (warp. is not drawn, but will teleport the player).
//climbable can be: 0 (can't climb), 1 (can ladder climb, no gravity applies), 2 (can climb, slow gravity applies), or 3 (can jump climb, no gravity applies). anything greater than or eqaul to 10 is to keep track of which warp is assigned to which warp recangle (10 = warp 0, 11 = warp 1, etc.).

