600 600
302 200
n n n n
200
503 341 6 10 0 2 255 51 51
497 340 9 12 0 2 255 51 51
488 350 15 15 0 2 255 51 51
487 336 6 14 0 2 255 51 51
461 364 18 8 0 2 255 51 51
467 329 21 18 0 2 255 51 51
490 340 10 25 0 2 255 51 51
454 335 31 12 0 2 255 51 51
423 363 27 6 0 2 255 51 51
389 356 24 12 0 2 255 51 51
383 346 25 11 0 2 255 51 51
390 338 45 9 0 2 255 51 51
421 325 32 26 0 2 255 51 51
404 346 85 19 0 2 255 51 51
453 327 3 30 0 2 255 51 51
498 264 15 8 0 2 255 51 51
522 263 18 7 0 2 255 51 51
499 262 41 6 0 2 255 51 51
550 230 12 12 0 2 255 51 51
506 232 39 9 0 2 255 51 51
517 228 19 10 0 2 255 51 51
481 230 28 10 0 2 255 51 51
455 253 16 4 0 2 255 51 51
472 262 32 8 0 2 255 51 51
450 242 22 14 0 2 255 51 51
461 236 104 28 0 2 255 51 51
433 172 16 6 0 2 255 51 51
419 168 18 10 0 2 255 51 51
413 143 9 12 0 2 255 51 51
419 145 20 8 0 2 255 51 51
407 166 22 12 0 2 255 51 51
414 172 15 9 0 2 255 51 51
398 153 24 15 0 2 255 51 51
433 139 10 23 0 2 255 51 51
403 150 68 13 0 2 255 51 51
442 143 18 8 0 2 255 51 51
418 157 52 13 0 2 255 51 51
424 166 39 9 0 2 255 51 51
138 80 7 13 0 2 255 51 51
150 88 16 6 0 2 255 51 51
187 80 8 10 0 2 255 51 51
168 86 16 9 0 2 255 51 51
171 64 5 27 0 2 255 51 51
134 73 21 12 0 2 255 51 51
144 67 27 12 0 2 255 51 51
155 62 16 13 0 2 255 51 51
172 68 18 23 0 2 255 51 51
145 78 29 13 0 2 255 51 51
274 191 8 13 0 2 255 51 51
266 188 9 19 0 2 255 51 51
257 190 15 18 0 2 255 51 51
207 203 50 6 0 2 255 51 51
227 181 31 20 0 2 255 51 51
205 187 56 18 0 2 255 51 51
191 199 25 6 0 2 255 51 51
202 202 13 12 0 2 255 51 51
-5 -5 615 575 0 0 51 220 255
198 184 35 15 3 0 255 255 255
219 178 45 17 3 0 255 255 255
255 186 31 23 3 0 255 255 255
247 201 30 17 3 0 255 255 255
220 207 35 17 3 0 255 255 255
200 201 33 18 3 0 255 255 255
188 194 47 16 3 0 255 255 255
203 185 67 32 3 0 255 255 255
131 267 113 298 1 0 60 51 51
134 534 86 4 0 0 51 0 0
134 499 87 5 0 0 51 0 0
133 459 87 4 0 0 51 0 0
132 423 89 5 0 0 51 0 0
132 398 90 4 0 0 51 0 0
134 361 87 5 0 0 51 0 0
199 267 6 296 0 0 51 0 0
173 267 6 297 0 0 51 0 0
147 267 6 296 0 0 51 0 0
130 325 89 5 0 0 51 0 0
132 297 87 5 0 0 51 0 0
-21 564 641 45 1 0 102 102 102
42 114 82 451 1 0 153 153 153
34 117 8 447 1 1 153 153 153
122 117 13 448 1 1 153 153 153
34 558 18 7 1 1 153 153 153
39 119 90 439 0 0 0 60 120
36 154 96 5 0 0 153 153 153
36 192 98 5 0 0 153 153 153
35 229 99 7 0 0 153 153 153
35 261 97 7 0 0 153 153 153
35 294 97 7 0 0 153 153 153
36 326 96 10 0 0 153 153 153
36 354 96 10 0 0 153 153 153
37 388 95 8 0 0 153 153 153
37 419 94 6 0 0 153 153 153
37 448 93 10 0 0 153 153 153
36 483 94 9 0 0 153 153 153
37 516 93 8 0 0 153 153 153
61 117 10 445 0 0 153 153 153
88 117 9 443 0 0 153 153 153
111 116 7 446 0 0 153 153 153
34 134 97 5 0 0 153 153 153
545 24 34 33 3 0 255 255 51
229 210 111 354 1 0 153 153 153
217 214 17 350 1 1 153 153 153
325 214 28 350 1 1 153 153 153
232 220 105 344 0 0 70 70 70
223 258 119 9 1 0 153 153 153
225 307 117 9 1 0 153 153 153
227 354 117 12 1 0 153 153 153
228 391 115 9 1 0 153 153 153
229 427 111 10 1 0 153 153 153
224 459 115 9 1 0 153 153 153
228 497 111 8 1 0 153 153 153
229 529 111 8 1 0 153 153 153
249 214 8 350 1 0 153 153 153
273 214 9 350 1 0 153 153 153
296 215 9 349 1 0 153 153 153
317 218 7 346 1 0 153 153 153
226 285 117 4 1 0 153 153 153
227 234 115 2 1 0 153 153 153
226 335 115 4 1 0 153 153 153
37 212 94 3 1 0 153 153 153
37 174 94 3 1 0 153 153 153
35 247 96 3 1 0 153 153 153
36 282 96 3 1 0 153 153 153
36 310 97 4 1 0 153 153 153
37 371 95 4 1 0 153 153 153
36 346 97 2 1 0 153 153 153
37 408 97 3 1 0 153 153 153
36 435 95 3 1 0 153 153 153
36 470 96 6 1 0 153 153 153
36 501 94 7 1 0 153 153 153
36 537 94 5 1 0 153 153 153
102 94 10 21 0 1 51 0 0
475 542 9 25 2 0 204 0 0
468 548 22 5 4 0 204 0 0
472 538 15 5 4 0 204 0 0
476 535 7 7 4 0 204 0 0
399 144 71 34 4 0 255 255 255
425 137 24 18 4 0 255 255 255
407 141 22 21 4 0 255 255 255
445 140 19 18 4 0 255 255 255
459 146 17 18 4 0 255 255 255
453 157 22 17 4 0 255 255 255
443 164 24 16 4 0 255 255 255
432 168 21 16 4 0 255 255 255
410 168 25 16 4 0 255 255 255
402 162 18 18 4 0 255 255 255
392 156 29 16 4 0 255 255 255
395 146 18 19 4 0 255 255 255
456 230 106 39 4 0 255 255 255
473 227 47 20 4 0 255 255 255
509 225 37 18 4 0 255 255 255
545 228 22 16 4 0 255 255 255
555 237 18 23 4 0 255 255 255
539 250 30 18 4 0 255 255 255
514 257 33 17 4 0 255 255 255
491 260 29 15 4 0 255 255 255
466 255 36 17 4 0 255 255 255
454 249 27 19 4 0 255 255 255
454 233 39 18 4 0 255 255 255
444 239 29 20 4 0 255 255 255
385 333 116 35 3 0 255 255 255
413 321 49 27 3 0 255 255 255
459 325 35 20 3 0 255 255 255
385 333 48 18 3 0 255 255 255
377 342 42 19 3 0 255 255 255
385 352 36 20 3 0 255 255 255
417 349 42 25 3 0 255 255 255
450 355 37 19 3 0 255 255 255
480 348 26 20 3 0 255 255 255
486 337 27 18 3 0 255 255 255
133 71 57 21 4 0 255 255 255
147 84 28 13 4 0 255 255 255
148 60 32 17 4 0 255 255 255
171 64 25 20 4 0 255 255 255
175 77 26 17 4 0 255 255 255
163 76 25 18 4 0 255 255 255
134 81 16 14 4 0 255 255 255
128 71 25 17 4 0 255 255 255
139 65 18 13 4 0 255 255 255
167 83 21 15 4 0 255 255 255
101 78 11 16 3 0 204 204 204
97 67 11 17 3 0 204 204 204
85 57 17 17 3 0 204 204 204
70 56 24 14 3 0 204 204 204
59 50 23 17 3 0 204 204 204
41 43 29 24 3 0 204 204 204
20 45 38 19 3 0 204 204 204
16 39 37 16 3 0 204 204 204
6 44 40 24 3 0 204 204 204
1 41 28 19 3 0 204 204 204
-5 48 24 20 3 0 204 204 204
217 210 15 5 1 3 153 153 153
338 210 15 13 1 3 153 153 153
129 114 6 19 1 3 153 153 153
34 114 5 13 1 3 153 153 153
38 114 13 5 1 0 153 153 153
121 114 10 5 1 0 153 153 153
217 210 12 7 1 3 153 153 153
335 210 18 10 1 3 153 153 153
464 564 39 10 2 0 102 102 102
0

//file format:

mapWidth mapHeight
spawnPointX spawnPointY
edgeWarpLeftMap edgeWarpRightMap edgeWarpUpMap edgeWarpDownMap //n means none, player just warps to opposite side of current map
numberOfShapesToReadFromTheFile
topLeftCornerX topLeftCornerY width height collision climbability r g b //each of these lines represents one shape
warpCount
warpToMapNum warpToXCoord warpToYCoord //n means warp destination is the same as current map

//collision can be: 0 (no collision, draw behind char), 1 (collision), 2 (no collision, draw in front of char), 3 (no collision oval, draw behind char), 4 (no collision oval, draw in front of char), or 5 (warp. is not drawn, but will teleport the player).
//climbable can be: 0 (can't climb), 1 (can ladder climb, no gravity applies), 2 (can climb, slow gravity applies), or 3 (can jump climb, no gravity applies). anything greater than or eqaul to 10 is to keep track of which warp is assigned to which warp recangle (10 = warp 0, 11 = warp 1, etc.).

